NO ./textures/wall_n_sprite.png
WE ./textures/wall_w_sprite.png
SO ./textures/wall_s_sprite.png
EA ./textures/wall_e_sprite.png

C 225,30,0
F 220,100,0

11111 111111111111111111111111111
10001 100000000000000000000000001
11111 100000000000000000000000001
      1000000000000N0000000000001
      100000000000000000000000001
      100000000000000000000000001
      111111111111111111111111111