NO ./textures/wall_n_sprite.png
WE ./textures/wall_w_sprite.png
SO ./textures/wall_s_sprite.png
EA ./textures/wall_e_sprite.png

F 255,150,0
C 255,20,0
        1111111111111111111111111


        1000000000110000000000001
        1011000001110N00000000001
111111111011000001110000000000001
100000000000000001110011111111111
11110111111111011100000010001
11110111111111011101010010001
11000000110101011100000010001
10000000000000000000000010001
10000000000000001101010000001
1100000111010101110101101000111
11110111 1110101 101111010001
11111111 1111111 111111111111