
NO ./textures/wall_n_sprite.png
WE ./textures/wall_w_sprite.png
SO ./textures/wall_s_sprite.png
EA ./textures/wall_e_sprite.png
              
F 0,128,0
C 173,216,230

111111111
1000001
111000  1111
11111100N0111
1111111111