
NO ./textures/wall_n_sprite.png
WE ./textures/wall_w_sprite.png
SO ./textures/wall_s_sprite.png
EA ./textures/wall_e_sprite.png
              
F 0,128,0
C 173,216,230

1110000
1000001
1000N01
1111111