NO ./path_to_the_north_texture
WE ./path_to_the_west_texture
SO ./path_to_the_south_texture
EA ./path_to_the_east_texture

C 225,30,0
F 220,100,0

111111111111111111111111111
100000000000000000000000001
100000000000111000000000001
1000000000001ND000000000001  111111
100000000000111000000000001  100001
100000000000000000000000001  111111
111111111111111111111111111