NO ./path_to_the_north_texture
WE ./path_to_the_west_texture
SO ./path_to_the_south_texture
EA ./path_to_the_east_texture

C 225,30,0
F 220,100,0

11111 111111111111111111111111111
10001 100000000000000000000000001
11111 1000000000001D1000000000001
      1000000000001N1000000000001
      100000000000111000000000001
      100000000000000000000000001
      111111111111111111111111111